    #####
    #   #
    #B  #
  ###  ###
  #  B  B #
### # ### #     ######
#   # ### #######  ..#
#    B              .#
##### #### #&####   .#
    #      ###  ######
    ########
