    #####
  ###&  #
  #. B .#
  #  B ##
 ### ###
## B  #
#     #
#.  ###
#####
