######
#.  .#
#    #
# BB #
#&   #
######
