 ########    
 #&##   #### 
 # B   B   # 
 #  B B BBB# 
 # BB# #   # 
##B    B   # 
#  B  BBBBB##
# B#### #   #
#  B....#   #
# ##....#BB #
# ##....   ##
#   ....#  # 
## #....#BB# 
 # #....#  # 
 #         # 
 #### ##B### 
    #    #   
    ###### 
