 ######
#.B&  #
###   #
#.##  #
# #   ##
#B XB  #
#   .  #
########
