######
#.  .#
#    #
#B  B#
#&   #
######
